수능완성 01~03강	
landscaping	조경
weed	잡초
liquid	"액상의, 액체의"
landscaper	"조경사, 정원사"
in advance	"미리, 사전에"
hesitate	"주저하다, 망설이다"
treatment	(약품 등에 의한) 처리
complex	(건물) 단지
lawn	잔디
approximately	"대략, 거의"
concern	"우려, 걱정"
rescue	"구조하다, 구출하다"
cage	우리
outgrow	너무 자라다
underfed	"음식을 제대로 먹지 못한, 영양 부족의"
clip	"자르다, 깎다"
be looking to do	~하기를 기대하다
hop	깡충깡충 뛰다
tear	"(-tore - torn) 뜯다, 찢다"
anticipation	"기대, 고대"
convey	"전달하다, 전하다"
endeavour	"노력, 시도"
transition	"이동, 변화"
take pride in	~을 자랑스럽게 여기다
hoop	(농구의) 링
renovate	보수하다
awesome	멋진
put ~ in place	~을 마련하다
dive	급강하
toss about	~을 사방으로 흔들다
bitterly	"몹시, 지독하게"
massive	거대한
gust of wind	돌풍
rip off	~을 떼어 내다
sting	찌르다
stream	"흘러내리다, 흐르다"
tenfold	10배로
rag doll	헝겊 인형
adolescent	청소년
motivation	동기
development	"(새로 밝혀진) 사실, 상황, 결과"
specific	구체적인
participation	참여
task	"과제, 과업"
assign	"할당하다, 부여하다"
expectation	기대
guidance	지침
logic	"논리적인 말, 논리(학)"
transparent	"명백한, 투명한"
context	맥락
relate ~ to ...	~을 …와 연관시키다
rule of thumb	경험 법칙
validity	타당성
virtually	"거의, 사실상"
fall on deaf ears	무시되다
intention	의도
format	형식
directness	솔직함
quality	자질
advent	출현
assumed name	가명
disreputable	"불명예스러운, 평판이 안 좋은"
cue	단서
evaluate	평가하다
virtual	가상의
anonymous	익명의
appreciate	"이해하다, 인정하다"
industrialization	산업화
cruelty	"잔인한 행위, 잔인함"
alternative	"다른, 대체 가능한"
doubtless	의심할 여지없이
turn a profit	이익을 내다
humanely	인도적으로
measurably	"눈에 띄게, 측정할 수 있게"
progression	"진전, 발전, 향상"
consist in	~에 있다
indivisible	"나눌 수 없는, 불가분의"
unfold	"드러나다, 전개되다"
consist of	~으로 이루어지다
unbundle	"개별로 나누다, 개별로 가격을 매기다"
paste	붙이다
confession	고백
spell out	~을 상세히 설명하다
coherent	일관성 있는
in one’s own right	"그 자체로, 혼자 힘으로"
self-contained	자립적인
constant	지속적인
invasion	"침해, 침범"
offending	"불쾌감을 주는, 성가신"
on the grounds that	~이라는 이유[근거]로
utilization	"활용, 이용"
interrupt	방해하다
represent	(~의 전형이) 되다
recipient	받는 사람
skeptical	회의적인
enhance	높이다
device	"기기, 장치"
ingest	삼키다
entangle	"(걸어서) 꼼짝 못 하게 하다, 얽어매다"
estimate	추정하다
endangered	멸종 위기에 처한
six-pack ring	6개들이 (캔 음료 등을 묶는 플라스틱) 고리
habitat	서식지
monk seal	몽크바다표범
nursery	"생육지, 생육 환경, 탁아소"
entanglement	"얽혀 듦, 걸려듦"
Steller sea lion	큰바다사자
critical	중요한
phase	"시기, 양상, 국면"
life cycle	생활 주기
container	"용기, 그릇"
canister	(뚜껑이 붙은) 깡통
aspect	"측면, 양상"
explain	(~의 이유를) 설명하다
decline	"감소, 하락"
regulation	"규정, 규제"
subject	"피험자, 대상"
informed consent	충분한 설명에 입각한 동의
proposed	"계획된, 제안된"
rigorous	"철저한, 엄격한"
oversee	감독하다
functionally	기능적으로
restriction	"규제, 제한"
associated	관련된
sidestep	피하다
ethical	윤리적인
involved	수반되는
presumably	"아마, 짐작건대"
potential	잠재적인
hazard	위험
devise	"고안하다, 생각해 내다"
drawback	"문제점, 결점"
generate	"만들어 내다, 발생시키다"
physiology	"생리, 생리 기능"
derive	"얻다, 끌어내다"
typical	"전형적인, 대표적인"
atypical	이례적인
interact	상호 작용을 하다
sensory	"감각적인, 감각의"
concrete	실체가 있는
manipulatable	"조작할 수 있는, 다룰 수 있는"
unique	"독특한, 고유한"
curriculum	교육 과정
adapt	"적합하게 하다, 조정하다"
mobility	"이동(성), 기동(성)"
expressive	"표현력이 있는, 표현적인"
demonstration	(작동 과정이나 사용법에 대한 시범) 설명
verifiable	확인할 수 있는
motor disability	행동 장애
finger paint	핑거페인팅용 물감(손가락으로 그림을 그릴 때 사용하는 물감)
constantly	끊임없이
refine	개선하다
aid	"돕다, 거들다"
NASA	미국 항공 우주국 (National Aeronautics and Space Administration)
Jet Propulsion Laboratory	제트 추진 연구소 (미국 NASA 산하기구)
allow for	~을 가능하게 하다
computer enhancement	컴퓨터 사용에 의한 화질 향상
MRI	자기 공명 영상법 (Magnetic Resonance Imaging)
CT	컴퓨터 단층 촬영 (Computerized Tomography)
astronomy	천문학
infrared sensor	적외선 센서
remotely	"멀리서, 원격으로"
surgeon	외과 전문의
map	"찾아내다, 발견하다"
brain tumor	뇌종양
Charge-Coupled Device chip technology	전하 결합 소자 칩 기술
stem from	~에서 유래하다
Hubble Telescope	허블 망원경
further	발전시키다
detection	"발견, 탐지"
resolution	해상도
distinguish	구별하다
resort to	~에 의지하다
scarring	흉터
radiation	방사능
exposure	노출
